111111111111
1.1........1
1.M........1
1.11..1T...1
1...1..1...1
1...1111..11
1.1..1.11..1
1.P1...1.1.1
1.11111....1
1.11....1..1
1....1..1..1
111111111111
