111111111111
1M.......T.1
1.1..11.11.1
1.1........1
1....P...1.1
111..1..1..1
1.1......1.1
1.1....11..1
1.1.1......1
1...111....1
1.....1....1
111111111111
