111111111111
1.....M....1
1111111111P1
1..........1
1.1111111111
1..........1
1..11......1
1..........1
1....11....1
1..........1
1111111111.1
1..........1
1..........1
1..1..1....1
1..........1
1..1..1....1
1...11.....1
1..........1
1.....T....1
1..........1
111111111111
